**************************
* * *                S *
* * *  *  *************  *
* *   *    ************    *
*    *                   *
******** ***** ***********
*                        *
** *********************
*      *              G  *
*  *      *********** *  *
*    *        ******* *  *
*       *                *
**************************
