**************************
* * *                S   *
* * *  *  *************  *
* *   *    ************  *
*    *                   *
******** ***** ***********
*                        *
** ***********************
*      *              G  *
*  *      *********** *  *
*    *        ******* *  *
*       *                *
**************************
